11111111111
10100000101
10100000101
10000000001
10000000001
11111111111